domain,uniq_human_visitors,uniq_bot_visitors,total_visitor_count,language_code,site_type
en.m.wikipedia.org,33261399,8400247,41661646,en,wikipedia
en.wikipedia.org,17009339,4851741,21861080,en,wikipedia
es.m.wikipedia.org,5668575,1977289,7645864,es,wikipedia
ru.m.wikipedia.org,5816762,1367179,7183941,ru,wikipedia
ja.m.wikipedia.org,5396108,1325212,6721320,ja,wikipedia
de.m.wikipedia.org,4439596,853251,5292847,de,wikipedia
fr.m.wikipedia.org,3798528,904567,4703095,fr,wikipedia
ru.wikipedia.org,2852296,687501,3539797,ru,wikipedia
es.wikipedia.org,2460489,962516,3423005,es,wikipedia
it.m.wikipedia.org,2806943,566876,3373819,it,wikipedia
de.wikipedia.org,2252670,844959,3097629,de,wikipedia
ja.wikipedia.org,2128471,576439,2704910,ja,wikipedia
fr.wikipedia.org,1839196,651811,2491007,fr,wikipedia
zh.m.wikipedia.org,2123391,328636,2452027,zh,wikipedia
ar.m.wikipedia.org,1644253,750620,2394873,ar,wikipedia
pt.m.wikipedia.org,1471752,694216,2165968,pt,wikipedia
pl.m.wikipedia.org,1410339,254991,1665330,pl,wikipedia
fa.m.wikipedia.org,1194940,385060,1580000,fa,wikipedia
zh.wikipedia.org,1088755,301391,1390146,zh,wikipedia
tr.m.wikipedia.org,908573,429975,1338548,tr,wikipedia
it.wikipedia.org,960563,363121,1323684,it,wikipedia
id.m.wikipedia.org,777850,485675,1263525,id,wikipedia
pt.wikipedia.org,734498,361300,1095798,pt,wikipedia
nl.m.wikipedia.org,816225,186294,1002519,nl,wikipedia
uk.m.wikipedia.org,799350,148493,947843,uk,wikipedia
pl.wikipedia.org,717953,219016,936969,pl,wikipedia
vi.m.wikipedia.org,430015,266113,696128,vi,wikipedia
sv.m.wikipedia.org,586638,99485,686123,sv,wikipedia
ko.m.wikipedia.org,592663,89442,682105,ko,wikipedia
nl.wikipedia.org,411116,183812,594928,nl,wikipedia
hi.m.wikipedia.org,372427,197143,569570,hi,wikipedia
th.m.wikipedia.org,371877,176545,548422,th,wikipedia
commons.wikimedia.org,163837,364266,528103,commons,wikimedia
cs.m.wikipedia.org,449440,70360,519800,cs,wikipedia
he.m.wikipedia.org,409324,77168,486492,he,wikipedia
commons.m.wikimedia.org,117812,358525,476337,commons,wikimedia
tr.wikipedia.org,306981,153916,460897,tr,wikipedia
fi.m.wikipedia.org,384300,68720,453020,fi,wikipedia
hu.m.wikipedia.org,369370,75809,445179,hu,wikipedia
vi.wikipedia.org,302448,106837,409285,vi,wikipedia
ko.wikipedia.org,247168,161134,408302,ko,wikipedia
ro.m.wikipedia.org,322606,83245,405851,ro,wikipedia
el.m.wikipedia.org,307925,73927,381852,el,wikipedia
uk.wikipedia.org,303240,69011,372251,uk,wikipedia
sv.wikipedia.org,272589,85040,357629,sv,wikipedia
cs.wikipedia.org,261877,79729,341606,cs,wikipedia
en.m.wiktionary.org,146792,190145,336937,en,wiktionary
ar.wikipedia.org,212695,97700,310395,ar,wikipedia
id.wikipedia.org,183975,123875,307850,id,wikipedia
en.wiktionary.org,123043,184577,307620,en,wiktionary
bg.m.wikipedia.org,255180,45962,301142,bg,wikipedia
ru.m.wiktionary.org,127103,153817,280920,ru,wiktionary
sr.m.wikipedia.org,242035,27347,269382,sr,wikipedia
hu.wikipedia.org,192206,69572,261778,hu,wikipedia
no.m.wikipedia.org,197814,46321,244135,no,wikipedia
bn.m.wikipedia.org,158172,84940,243112,bn,wikipedia
fi.wikipedia.org,176186,65289,241475,fi,wikipedia
hr.m.wikipedia.org,176889,38086,214975,hr,wikipedia
th.wikipedia.org,131685,77157,208842,th,wikipedia
da.m.wikipedia.org,160152,36403,196555,da,wikipedia
el.wikipedia.org,132834,54864,187698,el,wikipedia
ms.m.wikipedia.org,117263,61264,178527,ms,wikipedia
ro.wikipedia.org,115982,54244,170226,ro,wikipedia
no.wikipedia.org,116985,47137,164122,no,wikipedia
sk.m.wikipedia.org,119087,26316,145403,sk,wikipedia
da.wikipedia.org,99019,46332,145351,da,wikipedia
kk.m.wikipedia.org,116962,27183,144145,kk,wikipedia
ta.m.wikipedia.org,93643,47169,140812,ta,wikipedia
fa.wikipedia.org,91514,43775,135289,fa,wikipedia
he.wikipedia.org,95033,36288,131321,he,wikipedia
bg.wikipedia.org,92999,36892,129891,bg,wikipedia
ca.wikipedia.org,77291,44992,122283,ca,wikipedia
en.wikibooks.org,11221,102602,113823,en,wikibooks
el.m.wiktionary.org,74296,36994,111290,el,wiktionary
ru.wiktionary.org,45196,65116,110312,ru,wiktionary
ar.m.wikisource.org,56124,52885,109009,ar,wikisource
fr.m.wiktionary.org,38541,69134,107675,fr,wiktionary
az.m.wikipedia.org,80266,23450,103716,az,wikipedia
fr.wiktionary.org,33675,68784,102459,fr,wiktionary
ca.m.wikipedia.org,83071,17350,100421,ca,wikipedia
m.wikidata.org,51291,47889,99180,m,wikidata
simple.m.wikipedia.org,70728,27866,98594,simple,wikipedia
www.wikidata.org,18453,79033,97486,www,wikidata
sr.wikipedia.org,64143,32870,97013,sr,wikipedia
sk.wikipedia.org,65877,29084,94961,sk,wikipedia
ka.m.wikipedia.org,72068,22625,94693,ka,wikipedia
uz.m.wikipedia.org,67389,26674,94063,uz,wikipedia
hr.wikipedia.org,60920,32284,93204,hr,wikipedia
lt.m.wikipedia.org,73506,17215,90721,lt,wikipedia
simple.wikipedia.org,45911,43151,89062,simple,wikipedia
es.m.wiktionary.org,25802,60409,86211,es,wiktionary
mr.m.wikipedia.org,58518,27167,85685,mr,wikipedia
id.wikibooks.org,186,72661,72847,id,wikibooks
hy.m.wikipedia.org,57096,13865,70961,hy,wikipedia
de.m.wiktionary.org,26400,44317,70717,de,wiktionary
de.wiktionary.org,19997,48962,68959,de,wiktionary
sh.m.wikipedia.org,56335,11695,68030,sh,wikipedia
nl.wikibooks.org,294,67270,67564,nl,wikibooks
pl.m.wiktionary.org,23889,42407,66296,pl,wiktionary
sq.m.wikipedia.org,46747,19376,66123,sq,wikipedia
lt.wikipedia.org,39825,25318,65143,lt,wikipedia
te.m.wikipedia.org,40685,21830,62515,te,wikipedia
arz.m.wikipedia.org,45486,16769,62255,arz,wikipedia
ml.m.wikipedia.org,40854,18589,59443,ml,wikipedia
sl.m.wikipedia.org,48613,10325,58938,sl,wikipedia
fr.wikibooks.org,2113,56119,58232,fr,wikibooks
tl.m.wikipedia.org,36007,20389,56396,tl,wikipedia
et.wikipedia.org,32747,23476,56223,et,wikipedia
sl.wikipedia.org,29911,25842,55753,sl,wikipedia
it.wikibooks.org,352,55033,55385,it,wikibooks
ms.wikipedia.org,26750,28451,55201,ms,wikipedia
pl.wiktionary.org,17300,35166,52466,pl,wiktionary
el.wiktionary.org,27746,24575,52321,el,wiktionary
et.m.wikipedia.org,42903,8805,51708,et,wikipedia
sh.wikipedia.org,21387,27746,49133,sh,wikipedia
foundation.wikimedia.org,14490,34260,48750,foundation,wikimedia
zh-yue.m.wikipedia.org,39551,8963,48514,zh-yue,wikipedia
de.wikibooks.org,4179,44135,48314,de,wikibooks
pl.wikibooks.org,901,45765,46666,pl,wikibooks
meta.wikimedia.org,5680,40439,46119,meta,wikimedia
bs.m.wikipedia.org,37691,8232,45923,bs,wikipedia
ka.wikipedia.org,25577,18700,44277,ka,wikipedia
es.wiktionary.org,10783,33480,44263,es,wiktionary
es.wikibooks.org,953,43267,44220,es,wikibooks
zh-yue.wikipedia.org,25687,15453,41140,zh-yue,wikipedia
pt.wikibooks.org,484,40572,41056,pt,wikibooks
fi.wikibooks.org,168,40732,40900,fi,wikibooks
eu.wikipedia.org,12867,27207,40074,eu,wikipedia
tl.wikipedia.org,17918,21068,38986,tl,wikipedia
lv.wikipedia.org,18114,19870,37984,lv,wikipedia
kn.m.wikipedia.org,25983,11669,37652,kn,wikipedia
ca.wikibooks.org,50,37308,37358,ca,wikibooks
ur.m.wikipedia.org,23962,13073,37035,ur,wikipedia
az.wikipedia.org,17002,19915,36917,az,wikipedia
eu.wikibooks.org,9,36565,36574,eu,wikibooks
gl.wikipedia.org,6173,28243,34416,gl,wikipedia
id.m.wiktionary.org,4783,27535,32318,id,wiktionary
bs.wikipedia.org,13086,18571,31657,bs,wikipedia
lv.m.wikipedia.org,24391,6951,31342,lv,wikipedia
mk.m.wikipedia.org,22191,8385,30576,mk,wikipedia
zh.wikibooks.org,125,29715,29840,zh,wikibooks
ky.m.wikipedia.org,23733,6000,29733,ky,wikipedia
gl.wikibooks.org,23,29602,29625,gl,wikibooks
hy.wikipedia.org,12940,16417,29357,hy,wikipedia
ast.wikipedia.org,9812,18913,28725,ast,wikipedia
sq.wikibooks.org,32,28546,28578,sq,wikibooks
sq.wikipedia.org,8632,17937,26569,sq,wikipedia
en.m.wikibooks.org,7758,18442,26200,en,wikibooks
mk.wikipedia.org,9010,17091,26101,mk,wikipedia
en.wikiquote.org,3959,21852,25811,en,wikiquote
kk.wikipedia.org,16693,8534,25227,kk,wikipedia
af.wikipedia.org,3171,22020,25191,af,wikipedia
uz.wikipedia.org,7512,17650,25162,uz,wikipedia
www.mediawiki.org,5904,18384,24288,www,wiki
hr.wikibooks.org,26,23933,23959,hr,wikibooks
km.m.wikipedia.org,13757,9869,23626,km,wikipedia
vi.m.wiktionary.org,4884,18510,23394,vi,wiktionary
ja.wikibooks.org,2068,20911,22979,ja,wikibooks
nn.wikipedia.org,5159,17523,22682,nn,wikipedia
la.wikipedia.org,2349,20134,22483,la,wikipedia
hi.wikipedia.org,14706,7714,22420,hi,wikipedia
eo.wikipedia.org,2147,20216,22363,eo,wikipedia
arz.wikipedia.org,7579,14548,22127,arz,wikipedia
meta.m.wikimedia.org,8010,14012,22022,meta,wikimedia
ru.m.wikisource.org,10820,11141,21961,ru,wikisource
sw.m.wikipedia.org,12787,9130,21917,sw,wikipedia
en.wikisource.org,5790,16002,21792,en,wikisource
ja.wiktionary.org,6637,15132,21769,ja,wiktionary
ta.wikipedia.org,10969,10677,21646,ta,wikipedia
zh.m.wiktionary.org,5395,16122,21517,zh,wiktionary
is.wikipedia.org,5345,16039,21384,is,wikipedia
sv.wikibooks.org,61,20712,20773,sv,wikibooks
bn.wikipedia.org,13468,7267,20735,bn,wikipedia
la.wikibooks.org,10,20702,20712,la,wikibooks
vi.wiktionary.org,5327,15171,20498,vi,wiktionary
nl.wiktionary.org,3868,16266,20134,nl,wiktionary
it.m.wiktionary.org,5302,14430,19732,it,wiktionary
gu.m.wikipedia.org,13184,6232,19416,gu,wikipedia
fi.wiktionary.org,5252,13773,19025,fi,wiktionary
br.wikipedia.org,646,18293,18939,br,wikipedia
be.wikipedia.org,4642,13943,18585,be,wikipedia
oc.wikipedia.org,592,17627,18219,oc,wikipedia
als.wikipedia.org,1785,16413,18198,als,wikipedia
mn.m.wikipedia.org,11527,6482,18009,mn,wikipedia
sco.wikipedia.org,1969,16037,18006,sco,wikipedia
da.wikibooks.org,22,17795,17817,da,wikibooks
ast.m.wikipedia.org,12838,4539,17377,ast,wikipedia
incubator.wikimedia.org,315,17052,17367,incubator,wikimedia
sv.wiktionary.org,3629,13605,17234,sv,wiktionary
it.wiktionary.org,3335,13701,17036,it,wiktionary
cy.wikipedia.org,1042,15988,17030,cy,wikipedia
si.m.wikipedia.org,10813,6159,16972,si,wikipedia
en.m.wikisource.org,9908,6533,16441,en,wikisource
fi.m.wiktionary.org,6676,9739,16415,fi,wiktionary
sw.wikipedia.org,1519,14669,16188,sw,wikipedia
fy.wikipedia.org,537,15610,16147,fy,wikipedia
ru.m.wikiquote.org,6040,10037,16077,ru,wikiquote
et.wikibooks.org,10,15994,16004,et,wikibooks
lb.wikipedia.org,907,15047,15954,lb,wikipedia
pt.wiktionary.org,3889,12049,15938,pt,wiktionary
war.wikipedia.org,758,15118,15876,war,wikipedia
ko.wiktionary.org,2596,13054,15650,ko,wiktionary
lmo.wikipedia.org,822,14655,15477,lmo,wikipedia
en.wikivoyage.org,2624,12840,15464,en,wikivoyage
ja.m.wiktionary.org,4918,10544,15462,ja,wiktionary
zh-min-nan.wikipedia.org,719,14650,15369,zh-min-nan,wikipedia
ceb.wikipedia.org,1382,13520,14902,ceb,wikipedia
ilo.wikipedia.org,399,14378,14777,ilo,wikipedia
nds.wikipedia.org,1110,13640,14750,nds,wikipedia
hif.wikipedia.org,328,14378,14706,hif,wikipedia
bcl.wikipedia.org,1398,13255,14653,bcl,wikipedia
bar.wikipedia.org,1589,13031,14620,bar,wikipedia
li.wikipedia.org,660,13906,14566,li,wikipedia
zh.wiktionary.org,1559,12798,14357,zh,wiktionary
io.wikipedia.org,452,13764,14216,io,wikipedia
cs.wiktionary.org,3912,10294,14206,cs,wiktionary
be-tarask.wikipedia.org,1518,12667,14185,be-tarask,wikipedia
af.m.wikipedia.org,9589,4504,14093,af,wikipedia
ia.wikipedia.org,605,13466,14071,ia,wikipedia
diq.wikipedia.org,441,13584,14025,diq,wikipedia
nl.m.wiktionary.org,4545,9452,13997,nl,wiktionary
jv.wikipedia.org,847,13028,13875,jv,wikipedia
en.wikiversity.org,2088,11780,13868,en,wikiversity
vec.wikipedia.org,544,13237,13781,vec,wikipedia
ky.wikipedia.org,1763,11969,13732,ky,wikipedia
ga.wikipedia.org,662,13069,13731,ga,wikipedia
su.wikipedia.org,423,13271,13694,su,wikipedia
scn.wikipedia.org,644,13023,13667,scn,wikipedia
he.m.wikisource.org,7555,6010,13565,he,wikisource
my.m.wikipedia.org,7522,5967,13489,my,wikipedia
yo.wikipedia.org,257,13215,13472,yo,wikipedia
pt.m.wiktionary.org,4622,8797,13419,pt,wiktionary
cs.wikibooks.org,43,13374,13417,cs,wikibooks
frr.wikipedia.org,347,12974,13321,frr,wikipedia
tk.wikipedia.org,487,12804,13291,tk,wikipedia
bjn.wikipedia.org,506,12644,13150,bjn,wikipedia
fo.wikipedia.org,445,12697,13142,fo,wikipedia
simple.wikibooks.org,5,13024,13029,simple,wikibooks
en.m.wikiquote.org,4841,8092,12933,en,wikiquote
nso.wikipedia.org,136,12788,12924,nso,wikipedia
ta.m.wiktionary.org,4438,8485,12923,ta,wiktionary
hsb.wikipedia.org,337,12582,12919,hsb,wikipedia
te.wikipedia.org,4035,8655,12690,te,wikipedia
fiu-vro.wikipedia.org,315,12364,12679,fiu-vro,wikipedia
bg.m.wiktionary.org,4536,8125,12661,bg,wiktionary
tr.wikibooks.org,148,12443,12591,tr,wikibooks
ru.wikibooks.org,1869,10688,12557,ru,wikibooks
ku.wikipedia.org,578,11956,12534,ku,wikipedia
zh.m.wikisource.org,5659,6760,12419,zh,wikisource
cv.wikipedia.org,600,11715,12315,cv,wikipedia
gd.wikipedia.org,240,11985,12225,gd,wikipedia
ban.wikipedia.org,313,11823,12136,ban,wikipedia
fr.m.wikisource.org,5567,6553,12120,fr,wikisource
fr.wikisource.org,4212,7833,12045,fr,wikisource
hu.wikibooks.org,238,11790,12028,hu,wikibooks
nds-nl.wikipedia.org,992,11013,12005,nds-nl,wikipedia
smn.wikipedia.org,179,11790,11969,smn,wikipedia
avk.wikipedia.org,101,11860,11961,avk,wikipedia
xmf.wikipedia.org,511,11348,11859,xmf,wikipedia
mg.wikipedia.org,412,11436,11848,mg,wikipedia
vls.wikipedia.org,537,11294,11831,vls,wikipedia
tt.wikipedia.org,1239,10484,11723,tt,wikipedia
lt.wikibooks.org,28,11692,11720,lt,wikibooks
cs.m.wiktionary.org,4441,7220,11661,cs,wiktionary
eml.wikipedia.org,400,11253,11653,eml,wikipedia
gv.wikipedia.org,162,11462,11624,gv,wikipedia
se.wikipedia.org,321,11290,11611,se,wikipedia
de.m.wikibooks.org,5481,6097,11578,de,wikibooks
map-bms.wikipedia.org,202,11285,11487,map-bms,wikipedia
kab.wikipedia.org,231,11208,11439,kab,wikipedia
crh.wikipedia.org,285,11085,11370,crh,wikipedia
qu.wikipedia.org,281,11073,11354,qu,wikipedia
tpi.wikipedia.org,91,11262,11353,tpi,wikipedia
ur.wikipedia.org,3109,8175,11284,ur,wikipedia
sah.wikipedia.org,489,10744,11233,sah,wikipedia
ru.wikisource.org,2988,8199,11187,ru,wikisource
it.m.wikisource.org,4715,6450,11165,it,wikisource
wuu.wikipedia.org,1022,10135,11157,wuu,wikipedia
lij.wikipedia.org,345,10755,11100,lij,wikipedia
vo.wikipedia.org,216,10726,10942,vo,wikipedia
it.m.wikiquote.org,4991,5776,10767,it,wikiquote
gl.m.wikipedia.org,8144,2611,10755,gl,wikipedia
hy.m.wiktionary.org,6435,4123,10558,hy,wiktionary
tg.wikipedia.org,1059,9461,10520,tg,wikipedia
no.wikibooks.org,21,10467,10488,no,wikibooks
ckb.wikipedia.org,850,9565,10415,ckb,wikipedia
ja.m.wikibooks.org,3007,7390,10397,ja,wikibooks
hak.wikipedia.org,222,10164,10386,hak,wikipedia
he.wikibooks.org,415,9966,10381,he,wikibooks
tr.m.wiktionary.org,1943,8330,10273,tr,wiktionary
pam.wikipedia.org,277,9987,10264,pam,wikipedia
min.wikipedia.org,1399,8753,10152,min,wikipedia
olo.wikipedia.org,139,9907,10046,olo,wikipedia
nah.wikipedia.org,182,9857,10039,nah,wikipedia
ia.wikibooks.org,7,9986,9993,ia,wikibooks
kw.wikipedia.org,156,9785,9941,kw,wikipedia
zea.wikipedia.org,198,9716,9914,zea,wikipedia
es.m.wikisource.org,3873,6027,9900,es,wikisource
ml.wikipedia.org,3828,5999,9827,ml,wikipedia
nrm.wikipedia.org,152,9563,9715,nrm,wikipedia
an.wikipedia.org,1094,8597,9691,an,wikipedia
sv.m.wiktionary.org,3680,5916,9596,sv,wiktionary
gag.wikipedia.org,236,9339,9575,gag,wikipedia
pnb.wikipedia.org,497,9066,9563,pnb,wikipedia
ce.wikipedia.org,806,8683,9489,ce,wikipedia
it.wikiquote.org,1748,7652,9400,it,wikiquote
stq.wikipedia.org,163,9184,9347,stq,wikipedia
ca.wiktionary.org,1318,7952,9270,ca,wiktionary
krc.wikipedia.org,158,9023,9181,krc,wikipedia
ru.wikiquote.org,2252,6900,9152,ru,wikiquote
hu.wiktionary.org,944,8202,9146,hu,wiktionary
nn.m.wikipedia.org,5977,3167,9144,nn,wikipedia
pag.wikipedia.org,113,9024,9137,pag,wikipedia
wa.wikipedia.org,388,8740,9128,wa,wikipedia
tr.wiktionary.org,952,8172,9124,tr,wiktionary
nap.wikipedia.org,415,8582,8997,nap,wikipedia
ie.wikipedia.org,172,8823,8995,ie,wikipedia
nov.wikipedia.org,74,8752,8826,nov,wikipedia
eu.m.wikipedia.org,5660,3111,8771,eu,wikipedia
id.wiktionary.org,1175,7570,8745,id,wiktionary
ro.wiktionary.org,870,7867,8737,ro,wiktionary
xal.wikipedia.org,120,8583,8703,xal,wikipedia
ht.wikipedia.org,287,8332,8619,ht,wikipedia
eo.wikibooks.org,11,8475,8486,eo,wikibooks
en.m.wikivoyage.org,3362,5072,8434,en,wikivoyage
m.mediawiki.org,7163,1260,8423,m,wiki
pap.wikipedia.org,173,8248,8421,pap,wikipedia
species.wikimedia.org,1394,7025,8419,species,wikimedia
sc.wikipedia.org,382,8028,8410,sc,wikipedia
he.m.wiktionary.org,2614,5744,8358,he,wiktionary
szl.wikipedia.org,656,7690,8346,szl,wikipedia
frp.wikipedia.org,229,8115,8344,frp,wikipedia
id.m.wikisource.org,1076,7258,8334,id,wikisource
fur.wikipedia.org,88,8149,8237,fur,wikipedia
vep.wikipedia.org,238,7972,8210,vep,wikipedia
th.m.wiktionary.org,1829,6275,8104,th,wiktionary
mn.wikipedia.org,4651,3385,8036,mn,wikipedia
be.m.wikipedia.org,5333,2697,8030,be,wikipedia
ext.wikipedia.org,268,7655,7923,ext,wikipedia
as.m.wikipedia.org,5619,2287,7906,as,wikipedia
gor.wikipedia.org,826,7023,7849,gor,wikipedia
lfn.wikipedia.org,164,7666,7830,lfn,wikipedia
ha.wikipedia.org,266,7501,7767,ha,wikipedia
ru.m.wikinews.org,2649,5100,7749,ru,wikinews
za.wikipedia.org,110,7576,7686,za,wikipedia
na.wikipedia.org,72,7566,7638,na,wikipedia
shn.wikipedia.org,103,7516,7619,shn,wikipedia
en.m.wikiversity.org,2249,5368,7617,en,wikiversity
ksh.wikipedia.org,174,7373,7547,ksh,wikipedia
is.wikibooks.org,33,7514,7547,is,wikibooks
sr.m.wiktionary.org,2309,5206,7515,sr,wiktionary
it.wikisource.org,2560,4901,7461,it,wikisource
sn.wikipedia.org,207,7236,7443,sn,wikipedia
io.wiktionary.org,53,7353,7406,io,wiktionary
bh.m.wikipedia.org,4386,2952,7338,bh,wikipedia
ru.wikinews.org,483,6853,7336,ru,wikinews
ko.m.wiktionary.org,2284,5017,7301,ko,wiktionary
simple.wiktionary.org,924,6377,7301,simple,wiktionary
is.m.wikipedia.org,4365,2923,7288,is,wikipedia
dsb.wikipedia.org,174,7055,7229,dsb,wikipedia
ms.wikibooks.org,12,7137,7149,ms,wikibooks
li.wikibooks.org,12,7076,7088,li,wikibooks
gn.wikipedia.org,279,6770,7049,gn,wikipedia
mi.wikipedia.org,119,6891,7010,mi,wikipedia
hy.m.wikisource.org,4530,2389,6919,hy,wikisource
kl.wikipedia.org,115,6768,6883,kl,wikipedia
de.wikivoyage.org,840,5973,6813,de,wikivoyage
jam.wikipedia.org,88,6655,6743,jam,wikipedia
tr.m.wikiquote.org,1526,5212,6738,tr,wikiquote
uk.m.wiktionary.org,1733,4978,6711,uk,wiktionary
lad.wikipedia.org,146,6506,6652,lad,wikipedia
pih.wikipedia.org,92,6508,6600,pih,wikipedia
ne.m.wikipedia.org,4167,2377,6544,ne,wikipedia
ar.wikisource.org,2134,4355,6489,ar,wikisource
jbo.wikipedia.org,88,6385,6473,jbo,wikipedia
mt.wikipedia.org,289,6164,6453,mt,wikipedia
csb.wikipedia.org,186,6266,6452,csb,wikipedia
de.wikisource.org,1655,4782,6437,de,wikisource
m.wikisource.org,2984,3448,6432,m,wikisource
tl.wikibooks.org,76,6346,6422,tl,wikibooks
es.wikisource.org,1628,4738,6366,es,wikisource
th.wiktionary.org,810,5536,6346,th,wiktionary
ig.wikipedia.org,141,6192,6333,ig,wikipedia
mr.wikipedia.org,3345,2945,6290,mr,wikipedia
ta.m.wikisource.org,3368,2911,6279,ta,wikisource
tg.m.wikipedia.org,3426,2777,6203,tg,wikipedia
si.wikipedia.org,1975,4222,6197,si,wikipedia
ckb.m.wikipedia.org,3618,2576,6194,ckb,wikipedia
rw.wikipedia.org,161,5989,6150,rw,wikipedia
pms.wikipedia.org,213,5879,6092,pms,wikipedia
uk.m.wikisource.org,2760,3320,6080,uk,wikisource
pl.m.wikiquote.org,2827,3233,6060,pl,wikiquote
ro.m.wiktionary.org,1287,4755,6042,ro,wiktionary
rue.wikipedia.org,788,5218,6006,rue,wikipedia
pa.m.wikipedia.org,3159,2844,6003,pa,wikipedia
ang.wikipedia.org,386,5611,5997,ang,wikipedia
yi.wikipedia.org,543,5417,5960,yi,wikipedia
zu.wikipedia.org,145,5811,5956,zu,wikipedia
ceb.m.wikipedia.org,1649,4286,5935,ceb,wikipedia
roa-tara.wikipedia.org,96,5776,5872,roa-tara,wikipedia
kg.wikipedia.org,72,5798,5870,kg,wikipedia
bat-smg.wikipedia.org,314,5542,5856,bat-smg,wikipedia
az.wikibooks.org,58,5786,5844,az,wikibooks
pl.wikiquote.org,1153,4670,5823,pl,wikiquote
pl.m.wikisource.org,2325,3482,5807,pl,wikisource
kaa.wikipedia.org,109,5626,5735,kaa,wikipedia
mhr.wikipedia.org,238,5490,5728,mhr,wikipedia
ln.wikipedia.org,105,5580,5685,ln,wikipedia
ro.m.wikisource.org,2336,3346,5682,ro,wikisource
es.m.wikibooks.org,1401,4244,5645,es,wikibooks
ts.wikipedia.org,61,5567,5628,ts,wikipedia
bi.wikipedia.org,68,5539,5607,bi,wikipedia
cbk-zam.wikipedia.org,96,5500,5596,cbk-zam,wikipedia
zh.wikisource.org,1782,3771,5553,zh,wikisource
ta.wiktionary.org,414,5100,5514,ta,wiktionary
om.wikipedia.org,95,5406,5501,om,wikipedia
id.m.wikibooks.org,1179,4231,5410,id,wikibooks
tet.wikipedia.org,104,5284,5388,tet,wikipedia
de.wikiquote.org,389,4985,5374,de,wikiquote
sm.wikipedia.org,70,5280,5350,sm,wikipedia
et.wiktionary.org,289,5030,5319,et,wiktionary
fa.m.wikisource.org,1046,4269,5315,fa,wikisource
lld.wikipedia.org,93,5143,5236,lld,wikipedia
bg.wiktionary.org,1885,3305,5190,bg,wiktionary
fr.wikiversity.org,900,4256,5156,fr,wikiversity
en.wikinews.org,695,4426,5121,en,wikinews
km.m.wiktionary.org,1375,3741,5116,km,wiktionary
uz.m.wiktionary.org,1464,3630,5094,uz,wiktionary
sk.wikibooks.org,32,5061,5093,sk,wikibooks
cdo.wikipedia.org,230,4743,4973,cdo,wikipedia
pa.wikipedia.org,551,4399,4950,pa,wikipedia
wo.wikipedia.org,89,4838,4927,wo,wikipedia
he.wikisource.org,2309,2598,4907,he,wikisource
bn.m.wikisource.org,2936,1968,4904,bn,wikisource
thankyou.wikipedia.org,4638,234,4872,thankyou,wikipedia
fa.m.wiktionary.org,893,3961,4854,fa,wiktionary
uk.wikibooks.org,39,4768,4807,uk,wikibooks
de.m.wikivoyage.org,1705,3067,4772,de,wikivoyage
so.m.wikipedia.org,2729,2029,4758,so,wikipedia
lt.wiktionary.org,390,4296,4686,lt,wiktionary
ka.wikibooks.org,10,4647,4657,ka,wikibooks
species.m.wikimedia.org,1123,3521,4644,species,wikimedia
it.wikivoyage.org,535,4087,4622,it,wikivoyage
gcr.wikipedia.org,100,4494,4594,gcr,wikipedia
no.wiktionary.org,514,4056,4570,no,wiktionary
ff.wikipedia.org,47,4506,4553,ff,wikipedia
hy.wiktionary.org,1098,3413,4511,hy,wiktionary
ace.wikipedia.org,236,4215,4451,ace,wikipedia
ee.wikipedia.org,54,4391,4445,ee,wikipedia
ku.wiktionary.org,208,4169,4377,ku,wiktionary
bcl.m.wikipedia.org,2828,1541,4369,bcl,wikipedia
ru.m.wikibooks.org,1869,2500,4369,ru,wikibooks
hu.m.wiktionary.org,962,3394,4356,hu,wiktionary
szy.wikipedia.org,54,4296,4350,szy,wikipedia
wikisource.org,763,3578,4341,wikisource,wikisource
am.m.wikipedia.org,2697,1618,4315,am,wikipedia
ha.m.wikipedia.org,2351,1959,4310,ha,wikipedia
ar.m.wikiquote.org,776,3511,4287,ar,wikiquote
ca.m.wiktionary.org,1327,2946,4273,ca,wiktionary
hi.m.wiktionary.org,718,3446,4164,hi,wiktionary
simple.m.wiktionary.org,843,3297,4140,simple,wiktionary
ss.wikipedia.org,58,4065,4123,ss,wikipedia
es.m.wikiversity.org,1058,3063,4121,es,wikiversity
eu.wiktionary.org,34,4030,4064,eu,wiktionary
km.wikipedia.org,2393,1667,4060,km,wikipedia
min.m.wikipedia.org,2712,1330,4042,min,wikipedia
jv.m.wikipedia.org,2187,1851,4038,jv,wikipedia
pt.m.wikibooks.org,1069,2969,4038,pt,wikibooks
ay.wikipedia.org,100,3926,4026,ay,wikipedia
so.wikipedia.org,468,3558,4026,so,wikipedia
srn.wikipedia.org,49,3929,3978,srn,wikipedia
my.wikipedia.org,2055,1851,3906,my,wikipedia
mr.m.wikisource.org,2262,1625,3887,mr,wikisource
roa-rup.wikipedia.org,81,3800,3881,roa-rup,wikipedia
kbp.wikipedia.org,95,3782,3877,kbp,wikipedia
ki.wikipedia.org,38,3830,3868,ki,wikipedia
co.wikipedia.org,209,3616,3825,co,wikipedia
gl.wiktionary.org,44,3748,3792,gl,wiktionary
ro.wikibooks.org,40,3741,3781,ro,wikibooks
mg.wikibooks.org,2,3761,3763,mg,wikibooks
eo.wiktionary.org,58,3689,3747,eo,wiktionary
pl.wikisource.org,904,2810,3714,pl,wikisource
de.m.wikisource.org,1385,2302,3687,de,wikisource
pcd.wikipedia.org,322,3313,3635,pcd,wikipedia
pdc.wikipedia.org,130,3484,3614,pdc,wikipedia
kn.wikipedia.org,1772,1817,3589,kn,wikipedia
rm.wikipedia.org,167,3402,3569,rm,wikipedia
fr.m.wikiversity.org,1053,2454,3507,fr,wikiversity
uk.wiktionary.org,997,2493,3490,uk,wiktionary
es.wikiquote.org,210,3231,3441,es,wikiquote
sco.m.wikipedia.org,2315,1121,3436,sco,wikipedia
lg.wikipedia.org,55,3309,3364,lg,wikipedia
eo.m.wikipedia.org,1348,2005,3353,eo,wikipedia
als.m.wikipedia.org,2035,1268,3303,als,wikipedia
sr.wiktionary.org,613,2688,3301,sr,wiktionary
su.m.wikipedia.org,1774,1518,3292,su,wikipedia
be-tarask.m.wikipedia.org,1602,1687,3289,be-tarask,wikipedia
ja.m.wikisource.org,1688,1598,3286,ja,wikisource
sl.wikibooks.org,12,3256,3268,sl,wikibooks
sr.m.wikisource.org,1056,2187,3243,sr,wikisource
es.wikiversity.org,340,2888,3228,es,wikiversity
mwl.wikipedia.org,121,3098,3219,mwl,wikipedia
la.m.wikipedia.org,1421,1787,3208,la,wikipedia
ab.wikipedia.org,220,2984,3204,ab,wikipedia
da.wiktionary.org,163,3011,3174,da,wiktionary
tr.m.wikisource.org,636,2519,3155,tr,wikisource
oc.wikibooks.org,6,3127,3133,oc,wikibooks
he.m.wikiquote.org,1290,1834,3124,he,wikiquote
mzn.m.wikipedia.org,2171,952,3123,mzn,wikipedia
am.wikipedia.org,731,2376,3107,am,wikipedia
trv.wikipedia.org,24,3049,3073,trv,wikipedia
bs.wiktionary.org,18,3040,3058,bs,wiktionary
haw.wikipedia.org,96,2952,3048,haw,wikipedia
tk.m.wikipedia.org,1567,1466,3033,tk,wikipedia
fr.m.wikibooks.org,898,2128,3026,fr,wikibooks
ig.m.wikipedia.org,2856,170,3026,ig,wikipedia
ami.wikipedia.org,36,2980,3016,ami,wikipedia
ml.wiktionary.org,67,2943,3010,ml,wiktionary
ne.wikipedia.org,1351,1607,2958,ne,wikipedia
rmy.wikipedia.org,45,2896,2941,rmy,wikipedia
fr.wikivoyage.org,155,2782,2937,fr,wikivoyage
sk.wiktionary.org,79,2857,2936,sk,wiktionary
zh.m.wikiversity.org,1653,1280,2933,zh,wikiversity
tr.wikiquote.org,339,2580,2919,tr,wikiquote
my.wiktionary.org,83,2836,2919,my,wiktionary
bh.wikipedia.org,388,2530,2918,bh,wikipedia
uk.m.wikivoyage.org,997,1918,2915,uk,wikivoyage
th.m.wikibooks.org,576,2337,2913,th,wikibooks
pnb.m.wikipedia.org,986,1914,2900,pnb,wikipedia
pt.wikiquote.org,146,2734,2880,pt,wikiquote
mdf.wikipedia.org,98,2737,2835,mdf,wikipedia
fy.wikibooks.org,3,2822,2825,fy,wikibooks
he.wiktionary.org,1002,1807,2809,he,wiktionary
kn.m.wiktionary.org,1252,1545,2797,kn,wiktionary
tum.wikipedia.org,49,2743,2792,tum,wikipedia
azb.m.wikipedia.org,1210,1580,2790,azb,wikipedia
cy.wiktionary.org,22,2715,2737,cy,wiktionary
an.m.wikipedia.org,2019,713,2732,an,wikipedia
bm.wikipedia.org,38,2667,2705,bm,wikipedia
ltg.wikipedia.org,79,2626,2705,ltg,wikipedia
cy.wikibooks.org,1,2664,2665,cy,wikibooks
tt.m.wikipedia.org,1096,1561,2657,tt,wikipedia
tw.wikipedia.org,71,2566,2637,tw,wikipedia
id.wikisource.org,273,2361,2634,id,wikisource
ja.wikisource.org,666,1963,2629,ja,wikisource
it.m.wikibooks.org,654,1964,2618,it,wikibooks
sq.wiktionary.org,125,2481,2606,sq,wiktionary
it.m.wikivoyage.org,714,1890,2604,it,wikivoyage
wikitech.wikimedia.org,751,1851,2602,wikitech,wikitech
ar.wiktionary.org,262,2335,2597,ar,wiktionary
sv.m.wikisource.org,958,1634,2592,sv,wikisource
ty.wikipedia.org,46,2530,2576,ty,wikipedia
af.wikibooks.org,6,2509,2515,af,wikibooks
pl.wikivoyage.org,318,2187,2505,pl,wikivoyage
eo.wikiquote.org,87,2407,2494,eo,wikiquote
os.wikipedia.org,369,2090,2459,os,wikipedia
gor.m.wikipedia.org,1706,751,2457,gor,wikipedia
om.wiktionary.org,13,2440,2453,om,wiktionary
it.m.wikiversity.org,504,1949,2453,it,wikiversity
az.wiktionary.org,69,2371,2440,az,wiktionary
fr.wikiquote.org,269,2164,2433,fr,wikiquote
ba.wikipedia.org,698,1719,2417,ba,wikipedia
pl.m.wikivoyage.org,536,1873,2409,pl,wikivoyage
fj.wikipedia.org,51,2358,2409,fj,wikipedia
mad.wikipedia.org,62,2345,2407,mad,wikipedia
sh.m.wiktionary.org,801,1604,2405,sh,wiktionary
oc.wiktionary.org,40,2355,2395,oc,wiktionary
hr.wiktionary.org,240,2145,2385,hr,wiktionary
hi.m.wikibooks.org,720,1661,2381,hi,wikibooks
li.wiktionary.org,24,2330,2354,li,wiktionary
cy.m.wikipedia.org,845,1502,2347,cy,wikipedia
ml.m.wiktionary.org,543,1761,2304,ml,wiktionary
pt.m.wikisource.org,1022,1268,2290,pt,wikisource
azb.wikipedia.org,601,1687,2288,azb,wikipedia
tay.wikipedia.org,29,2257,2286,tay,wikipedia
ru.m.wikivoyage.org,575,1709,2284,ru,wikivoyage
et.wikiquote.org,84,2192,2276,et,wikiquote
zh-min-nan.m.wikipedia.org,596,1678,2274,zh-min-nan,wikipedia
mg.wiktionary.org,35,2209,2244,mg,wiktionary
az.m.wikisource.org,762,1434,2196,az,wikisource
zh.m.wikiquote.org,625,1559,2184,zh,wikiquote
fa.wiktionary.org,182,1958,2140,fa,wiktionary
oc.m.wikipedia.org,250,1875,2125,oc,wikipedia
bar.m.wikipedia.org,1526,597,2123,bar,wikipedia
kn.wiktionary.org,52,2056,2108,kn,wiktionary
sh.wiktionary.org,445,1641,2086,sh,wiktionary
is.wiktionary.org,139,1947,2086,is,wiktionary
war.m.wikipedia.org,679,1406,2085,war,wikipedia
xh.wikipedia.org,73,2006,2079,xh,wikipedia
it.wikiversity.org,238,1796,2034,it,wikiversity
ar.m.wiktionary.org,448,1577,2025,ar,wiktionary
cv.m.wikipedia.org,1029,990,2019,cv,wikipedia
af.wiktionary.org,128,1879,2007,af,wiktionary
uz.wiktionary.org,195,1785,1980,uz,wiktionary
sk.wikiquote.org,45,1933,1978,sk,wikiquote
lt.m.wiktionary.org,490,1485,1975,lt,wiktionary
ka.wiktionary.org,177,1792,1969,ka,wiktionary
ku.m.wikipedia.org,837,1130,1967,ku,wikipedia
cs.wikiquote.org,117,1840,1957,cs,wikiquote
shi.wikipedia.org,48,1900,1948,shi,wikipedia
uk.m.wikiquote.org,836,1090,1926,uk,wikiquote
ch.wikipedia.org,46,1867,1913,ch,wikipedia
lb.m.wikipedia.org,652,1257,1909,lb,wikipedia
pl.m.wikibooks.org,562,1343,1905,pl,wikibooks
or.m.wikipedia.org,1216,683,1899,or,wikipedia
su.wikibooks.org,2,1891,1893,su,wikibooks
fi.wikiquote.org,104,1788,1892,fi,wikiquote
wuu.m.wikipedia.org,789,1094,1883,wuu,wikipedia
ny.wikipedia.org,63,1820,1883,ny,wikipedia
dag.wikipedia.org,51,1827,1878,dag,wikipedia
pt.m.wikiversity.org,833,1041,1874,pt,wikiversity
av.wikipedia.org,198,1672,1870,av,wikipedia
id.m.wikiquote.org,153,1711,1864,id,wikiquote
te.m.wikisource.org,858,984,1842,te,wikisource
th.m.wikisource.org,564,1271,1835,th,wikisource
vi.wikibooks.org,178,1656,1834,vi,wikibooks
nds.m.wikipedia.org,741,1088,1829,nds,wikipedia
fy.m.wikipedia.org,503,1321,1824,fy,wikipedia
de.m.wikiquote.org,684,1130,1814,de,wikiquote
de.wikiversity.org,471,1329,1800,de,wikiversity
th.wikibooks.org,124,1674,1798,th,wikibooks
ru.m.wikiversity.org,427,1370,1797,ru,wikiversity
ban.m.wikipedia.org,1193,589,1782,ban,wikipedia
la.wiktionary.org,59,1720,1779,la,wiktionary
tr.m.wikibooks.org,376,1400,1776,tr,wikibooks
te.wiktionary.org,30,1746,1776,te,wiktionary
ur.wiktionary.org,28,1732,1760,ur,wiktionary
no.m.wiktionary.org,480,1278,1758,no,wiktionary
scn.m.wikipedia.org,737,1014,1751,scn,wikipedia
zh.m.wikibooks.org,470,1268,1738,zh,wikibooks
co.wikibooks.org,1,1728,1729,co,wikibooks
bug.wikipedia.org,57,1671,1728,bug,wikipedia
pt.wikiversity.org,145,1539,1684,pt,wikiversity
sq.m.wiktionary.org,452,1226,1678,sq,wiktionary
es.m.wikivoyage.org,629,1043,1672,es,wikivoyage
mzn.wikipedia.org,325,1334,1659,mzn,wikipedia
ko.wikibooks.org,44,1612,1656,ko,wikibooks
tl.wiktionary.org,156,1497,1653,tl,wiktionary
en.m.wikinews.org,1043,609,1652,en,wikinews
br.wiktionary.org,37,1599,1636,br,wiktionary
es.wikivoyage.org,114,1517,1631,es,wikivoyage
ce.m.wikipedia.org,744,870,1614,ce,wikipedia
ru.wikivoyage.org,389,1225,1614,ru,wikivoyage
ast.wiktionary.org,18,1596,1614,ast,wiktionary
lt.wikiquote.org,46,1565,1611,lt,wikiquote
fr.m.wikiquote.org,457,1150,1607,fr,wikiquote
hif.m.wikipedia.org,888,716,1604,hif,wikipedia
pfl.wikipedia.org,160,1438,1598,pfl,wikipedia
sah.m.wikipedia.org,798,800,1598,sah,wikipedia
ml.m.wikisource.org,564,1028,1592,ml,wikisource
de.wikinews.org,60,1528,1588,de,wikinews
ast.wikibooks.org,3,1569,1572,ast,wikibooks
jv.m.wiktionary.org,212,1359,1571,jv,wiktionary
ko.wikisource.org,232,1338,1570,ko,wikisource
co.wiktionary.org,15,1547,1562,co,wiktionary
mg.m.wikipedia.org,499,1063,1562,mg,wikipedia
rue.m.wikipedia.org,1101,438,1539,rue,wikipedia
te.m.wiktionary.org,374,1160,1534,te,wiktionary
tg.wiktionary.org,20,1510,1530,tg,wiktionary
el.m.wikisource.org,667,841,1508,el,wikisource
br.m.wikipedia.org,563,938,1501,br,wikipedia
lo.wiktionary.org,18,1474,1492,lo,wiktionary
gn.m.wikipedia.org,789,699,1488,gn,wikipedia
km.wiktionary.org,224,1261,1485,km,wiktionary
ang.wikibooks.org,2,1482,1484,ang,wikibooks
incubator.m.wikimedia.org,268,1203,1471,incubator,wikimedia
gu.wikipedia.org,654,796,1450,gu,wikipedia
bn.wiktionary.org,64,1371,1435,bn,wiktionary
fr.wikinews.org,102,1331,1433,fr,wikinews
ht.m.wikipedia.org,563,864,1427,ht,wikipedia
nl.m.wikibooks.org,371,1056,1427,nl,wikibooks
hr.m.wiktionary.org,331,1080,1411,hr,wiktionary
vls.m.wikipedia.org,486,919,1405,vls,wikipedia
vi.m.wikisource.org,453,939,1392,vi,wikisource
mn.m.wiktionary.org,459,914,1373,mn,wiktionary
nl.wikivoyage.org,45,1327,1372,nl,wikivoyage
st.wikipedia.org,53,1314,1367,st,wikipedia
hy.wikibooks.org,13,1339,1352,hy,wikibooks
ia.m.wikipedia.org,433,918,1351,ia,wikipedia
ar.m.wikiversity.org,389,958,1347,ar,wikiversity
uk.wikisource.org,353,991,1344,uk,wikisource
as.wikipedia.org,416,926,1342,as,wikipedia
pt.wikisource.org,179,1163,1342,pt,wikisource
ps.m.wikipedia.org,663,673,1336,ps,wikipedia
ro.wikisource.org,342,986,1328,ro,wikisource
ca.wikiquote.org,47,1275,1322,ca,wikiquote
ba.m.wikipedia.org,736,585,1321,ba,wikipedia
os.m.wikipedia.org,197,1113,1310,os,wikipedia
foundation.m.wikimedia.org,66,1236,1302,foundation,wikimedia
ja.m.wikinews.org,498,795,1293,ja,wikinews
af.m.wiktionary.org,488,803,1291,af,wiktionary
bjn.m.wikipedia.org,819,467,1286,bjn,wikipedia
es.m.wikiquote.org,593,687,1280,es,wikiquote
el.wikibooks.org,27,1247,1274,el,wikibooks
nds-nl.m.wikipedia.org,871,403,1274,nds-nl,wikipedia
hr.wikiquote.org,25,1249,1274,hr,wikiquote
he.m.wikibooks.org,356,916,1272,he,wikibooks
tn.wikipedia.org,51,1219,1270,tn,wikipedia
bs.wikibooks.org,5,1263,1268,bs,wikibooks
aa.wikibooks.org,1,1264,1265,aa,wikibooks
lv.wiktionary.org,50,1208,1258,lv,wiktionary
or.wikipedia.org,315,939,1254,or,wikipedia
zh.m.wikivoyage.org,236,1013,1249,zh,wikivoyage
chy.wikipedia.org,37,1210,1247,chy,wikipedia
ar.m.wikibooks.org,378,855,1233,ar,wikibooks
hr.m.wikisource.org,738,489,1227,hr,wikisource
ms.m.wiktionary.org,365,841,1206,ms,wiktionary
ka.m.wiktionary.org,252,936,1188,ka,wiktionary
bn.m.wiktionary.org,188,995,1183,bn,wiktionary
sw.wiktionary.org,26,1150,1176,sw,wiktionary
sl.wiktionary.org,68,1107,1175,sl,wiktionary
zh-classical.wikipedia.org,562,604,1166,zh-classical,wikipedia
na.wikibooks.org,0,1153,1153,na,wikibooks
xmf.m.wikipedia.org,562,585,1147,xmf,wikipedia
sq.m.wikibooks.org,236,906,1142,sq,wikibooks
bs.wikiquote.org,36,1102,1138,bs,wikiquote
sv.wikiquote.org,38,1095,1133,sv,wikiquote
as.m.wikisource.org,503,624,1127,as,wikisource
el.wikisource.org,398,729,1127,el,wikisource
ga.m.wikipedia.org,384,743,1127,ga,wikipedia
hu.m.wikibooks.org,334,791,1125,hu,wikibooks
wa.wiktionary.org,17,1106,1123,wa,wiktionary
fr.m.wikivoyage.org,355,764,1119,fr,wikivoyage
lmo.m.wikipedia.org,622,494,1116,lmo,wikipedia
he.wikiquote.org,280,833,1113,he,wikiquote
sd.wikipedia.org,319,792,1111,sd,wikipedia
ik.wikipedia.org,50,1060,1110,ik,wikipedia
ps.wikipedia.org,363,746,1109,ps,wikipedia
ko.m.wikisource.org,527,579,1106,ko,wikisource
ru.wikiversity.org,200,899,1099,ru,wikiversity
el.m.wikivoyage.org,242,852,1094,el,wikivoyage
sn.m.wikipedia.org,608,480,1088,sn,wikipedia
sg.wiktionary.org,11,1074,1085,sg,wiktionary
rn.wikipedia.org,23,1062,1085,rn,wikipedia
hu.wikiquote.org,68,1011,1079,hu,wikiquote
ky.wiktionary.org,21,1039,1060,ky,wiktionary
ie.wikibooks.org,3,1054,1057,ie,wikibooks
hi.wiktionary.org,116,940,1056,hi,wiktionary
nl.wikiquote.org,35,1019,1054,nl,wikiquote
hy.wikisource.org,446,606,1052,hy,wikisource
kn.m.wikisource.org,340,712,1052,kn,wikisource
cs.m.wikiquote.org,299,751,1050,cs,wikiquote
fa.m.wikiquote.org,337,713,1050,fa,wikiquote
diq.m.wikipedia.org,459,591,1050,diq,wikipedia
ve.wikipedia.org,26,1023,1049,ve,wikipedia
ms.wiktionary.org,99,948,1047,ms,wiktionary
bg.m.wikiquote.org,271,775,1046,bg,wikiquote
lo.wikipedia.org,254,791,1045,lo,wikipedia
map-bms.m.wikipedia.org,657,388,1045,map-bms,wikipedia
fa.m.wikibooks.org,168,876,1044,fa,wikibooks
vec.wiktionary.org,10,1031,1041,vec,wiktionary
pt.wikinews.org,48,987,1035,pt,wikinews
pt.wikivoyage.org,58,977,1035,pt,wikivoyage
sl.wikiquote.org,25,1009,1034,sl,wikiquote
bo.m.wikipedia.org,588,446,1034,bo,wikipedia
uz.wikibooks.org,0,1033,1033,uz,wikibooks
om.m.wikipedia.org,509,524,1033,om,wikipedia
he.m.wikivoyage.org,219,806,1025,he,wikivoyage
kk.wiktionary.org,18,1007,1025,kk,wiktionary
lo.m.wikipedia.org,489,516,1005,lo,wikipedia
